XXXXXXXXXXX                                     )
X         X     XXXXXXXXXXXXXXXXX               )
X    P    XXXXXXX               X               )
X              B       X    E   X               )
X         XXXXXXX      X        X               )
XXXXX  XXXXXXXXXXX     XXXX  XXXXXXXXXXXX       )
    X  XXXXXXXXXXX     X           X    X       )
    X  XXXXXXXXXXX     X           X    X       )
    X  X         X     XXXXXXXXXXXXX    X       )
    X            X     X                X       )
    X  X         X     X      E         X       )
    X  XXXXXXXXXXX     X                X       )
    X  XXXXXXXXXXX     XXXXXXXXXXXXX  XXX       )
    X                      X            X       )
    X            R         X        B   X       )
    X      E               X     E      X       )
    X                                   X       )
    XXXXXXXXXXXXXXXXXXXXXXXXXXXXXXXXXXXXX       )
