XXXXXXXXXXX                                                                                        )
X         X     XXXXXXXXXXXXXXXXX   XXXXXXXXXXXXXXXXXXXXXXXXXXXXXXXXXXXXXXXXXXXXXXXXXXX            )
X    P    XXXXXXX               X   X             B                                   X            )
X              B       X    C   X   X  XXXXXXXXXXXXXXXXXXXXXXXXXX    XXXXXXXXXXXXX    X            )
X         XXXXXXX      X        X   X  X    X                   X      R   X          X            )
XXXXX  XXXXXXXXXXX     XXXX  XXXXXXXX  XX   X         X         X    X     X #   X    X            )
    X  XXXXXXXXXXX     X   R       X    X   X         X         X    X  +  X  +  X    X            )
    X  XXXXXXXXXXX     X  +     ^  X    X   X     +   X B     B X    X +   X     XB  BX            )
    X  X     #   X     XXXXXXXXXXXXX    X   X ^       X         X    XXXXXXXXXXXXX    XXXXXXXXXXXXX)
    X    R     + X     X                X   X      #  X         X    X           #                X)
    X  X     +   X     X      C    C    X   X   #     X              X   R           +            X)
    X  XXXXXXXXXXX     X   #            X   X  ^      X         X    X     XXXXX        XXXXX     X)
    X  XXXXXXXXXXX     XXXXXXXXXXXXX  XXX XXXXXXXXXXXXXXXXXXXXXXX    X      C      B        C     X)
    X                      X            X X           C         X    X +                          X)
    X            R       + X            X X  ^                  X    X     XXXXX C      XXXXXR    X)
    X      C               X     C      X X  #     C            X    X    R                       X)
    X                                   X X           C              X                     C      X)
    XXXXXXXXXXXXXXXXXXXXXXXXXXXXXXXXXXXXX XXXXXXXXXXXXXXXXXXXXXXXXXXXX B   XXXXX        XXXXX     X)
                                                            X  +  ^  X         +     R        ^   X)
                                                            X           B                         X)
                                                            XXXXWXXXXXXXXXXXXXXXXXXXXXXXXXXXXXXXXXX)