XXXXXXXXXXXXXXXXXXXXXXXXXXXXXXXXXXXXXXX
X         XXXXXXXXXXXXXXXXXXXXXXXXXXXXX
X         XXXXXXXXXXXXXXXXXXXXXXXXXXXXX
X    P              C  #  +   XXXXXXXXX
X         XXXXXXXXXXXXXXXXXX  XXXXXXXXX
X         XXXXX                 XXXXXXX
XXXXXXXXXXXXXXX                 XXXXXXX
XXX  R             C            XXXXXXX
XXX   +  XXXXXX                 XXXXXXX
XXX      XXXXXX                 XXXXXXX
XXXXXXXXXXXXXXXXX  XXXXXXXXXXXXXXXXXXXX
XXX       XXXXXXX  XXXXXXXXXXXXXXXXXXXX
XXX   W   XXXXXXX        XX   C     + X
XXX       XXXXXXX  XXXX  XX        ^  X
XXX       XXXXXXX  XXXX         C     X
XXX          C           XXXXXXXXXXXXXX
XXXXXXXXXXXXXXXXX  XXXX  XXXXXXXXXXXXXX
XXXXXXXXXXXXXXXXX  XXXX  XXXXXXXXXXXXXX
XXXXXXXXXXXXXXXXX      R XXXXXXXXXXXXXX
XXXXXXXXXXXXXXXXXXXXXXXXXXXXXXXXXXXXXXX