XXXXXXXXXXXXXXXXXXXXXXXXXXXXXXXXXXXXXXXXXXXXXXXXXXXXXXXXXXXXXXXXXXXXXXXXXXXXXXXXXXXXXXXXX
XXXXXXXXXXXXXXXXXXXXXX                            XXXXXXXXXXXXXXXXXXXXXXXXXXXXXXXXXXXXXXX
XXXXXXXXXXXXXXXXXXXXXX            XXXXXXXXXX      XXXXXXXXXXXXXXXXXXXXXXXXXXXXXXXXXXXXXXX
XXXXXXXXXXXXXXXXXXXXXX            XXXXXXXXXXXXXXX XXXXXXXXXXXXXXXXXXXXXXXXXXX           X
X                                   B          CC                     C        R        X
X     XXXXXXXXXXXXXXXX  X+X  XXX  XXXXXXX  XXXXXXXXXXXX XXXXX  XXXXXXXXXXXXXX           X
XC W  XXXXXXXXXXXXXXXX  XXX  XXX  XXXXXXX  XXXX         XXXXX  +XXXXXXXXXXXXX     P     X
X     XXXXXXXXXXXXXXXX  XXX  XXX  XXXXXXX  XXXX XXXXXXXXXXXXX  XXXXXXXXXXXXXX           X
X                                                   B                B         +        X
XXXXXXXXXXXX XXXXXXXXX            XXXXXXXXXXXXXXXXXXXXXXXXXXXXXXX  XXXXXXXXXX           X
XXXXXXX      XXXXXXXXX     B      XXXXXXXXXXXXXXXXXXXXXXXXXXX+     XXXXXXXXXXXXXXXXXXXXXX
XXXXXXX^ X   XXXXXXXXX            XXXXXXXXXXXXXXXXXXXXXXXXXXX  #   XXXXXXXXXXXXXXXXXXXXXX
XXXXXXXXXXXXXXXXXXXXXXXXXXXXXXXXXXXXXXXXXXXXXXXXXXXXXXXXXXXXXXXXXXXXXXXXXXXXXXXXXXXXXXXXX