XXXXXXXXXXXXXXXXXXXXXXXXXXXXXXXXXXXXXXXXXXXXXXXXXXXXXXXXXXXXXXXXXXXXXXXXXXXXXXXXXXXXXXXXXXXXXXXXXXX
X         XXXXXXXXXXXXXXXXXXXXXXXXXXXXXXXXXXXXXXXXXXXXXXXXXXXXXXXXXXXXXXXXXXXXXXXXXXXXXXXXXXXXXXXXX
X    P    XXXXXXX               XXXXX             B                                   XXXXXXXXXXXXX
X              B       X    C   XXXXX  XXXXXXXXXXXXXXXXXXXXXXXXXX    XXXXXXXXXXXXX    XXXXXXXXXXXXX
X         XXXXXXX      X        XXXXX  XXXXXX                   X      R   XXXXXXX    XXXXXXXXXXXXX
XXXXX  XXXXXXXXXXX     XXXX  XXXXXXXX  XXXXXX         X         X    X     XXXXXXX    XXXXXXXXXXXXX
XXXXX  XXXXXXXXXXX     X           X    XXXXX         X         X    X  +  XXXXXXX    XXXXXXXXXXXXX
XXXXX  XXXXXXXXXXX     X  +     #  X    XXXXX     +   X B     B X    X +   XXXXXXXB  BXXXXXXXXXXXXX
XXXXX  X         X     XXXXXXXXXXXXX    XXXXX         X         X    XXXXXXXXXXXXX    XXXXXXXXXXXXX
XXXXX          + X     X                XXXXX         X         X    X              +             X
XXXXX  X     +   X     X      C    C    XXXXX      #  X              X   R                        X
XXXXX  XXXXXXXXXXX     X                XXXXX  ^      X         X    X     XXXXX        XXXXX     X
XXXXX  XXXXXXXXXXX     XX XXXXXXXXXXXXXXXXXXXXXXXXXXXXXXXXXXXXXXX    X      C               C     X
XXXXX                      XXXXXXXXXXXXXXXX           C         X    X                            X
XXXXX R          R         XXXXXXXXXXXXXXXX                     X    X     XXXXX C      XXXXXR    X
XXXXX      C               XXXXXXXXXXXXXXXX  #     C            X    X    R                    +  X
XXXXX                      XXXXXXXXXXXXXXXX           C              X                     C      X
XXXXXXXXXXXXXXXXXXXXXXXXXXXXXXXXXXXXXXXXXXXXXXXXXXXXXXXXXXXXXXXXXXXXXX B   XXXXX        XXXXX     X
XXXXXXXXXXXXXXXXXXXXXXXXXXXXXXXXXXXXXXXXXXXXXXXXXXXXXXXXXXXXX     +  X               R            X
XXXXXXXXXXXXXXXXXXXXXXXXXXXXXXXXXXXXXXXXXXXXXXXXXXXXXXXXXXXXX   W       B                         X
XXXXXXXXXXXXXXXXXXXXXXXXXXXXXXXXXXXXXXXXXXXXXXXXXXXXXXXXXXXXXXXXXXXXXXXXXXXXXXXXXXXXXXXXXXXXXXXXXXX