XXXXXXXXXXXXXXXXXXXXXXXXXXXXXXXXXXXXXXXXXXXXXX
X                                            X
X              XXX      XXX                  X
X              XXX      XXX                  X
X                                  X         X
X                                  X     +   X
X   P +                            X   M     X
X                                  X     +   X
X                                  X         X
X              XXX      XXX                  X
X              XXX      XXX                  X
X                                            X
XXXXXXXXXXXXXXXXXXXXXXXXXXXXXXXXXXXXXXXXXXXXXX